00000000000000000000000000000000
00000000000000000000000000000000
00005000000000000000000000000000
00000000000000000000000000000000
44444444000000000000000000000000
00000000000000000000000000000000
00000000000004000000000000000000
00000000000000000000000000000000
00000000000000000000000000000000
00000000000000000004444400000000
00000000000000000000000000000000
00000000000000000000000000000000
30000000000004400000000000000200
00000000000000000000000000000000
00000000000000000000000000000000
00000004400000000000000000000000
00000000000000000000000000000000
11111111111111111111111111111111