00000000000000000000000000000000
00000000000000000000000000000000
00000000000000000000000000000000
00000000000000000000000000000000
00000000000000000000000000000200
50000000000000000000000000000000
44440000000000000000000000000000
00000000000000000000000000000000
00000000004444400000000000000000
00000000000000000000000000004440
00000000000000000000000440000000
00300000000000000000000000000000
00000000000000000000400000000000
00000000000000000000000000000000
00000000004444440000000000000000
00000000000004000000000000000000
99999990000004000000000009999999
11111110000004000000000001111111