00000000000000000000000000000000
00000000000000000000000000000000
00000000000000000000000000000000
00000000000000000000000000000000
00000000000000000000000000000000
00000000000000000000000000000000
00000000000000000000000000000000
00000000000000000000000000000000
00000000000000000000000000000000
00000000000000000000000000000000
00000000000000000000000000000000
20000000000000000000000000000020
00000000000000000000000000000000
00000000000000000000000000000000
00000000000000000000000000000000
00000000000000000005000000000000
99999999999999999999999999999999
11111111111111111111111111111111