00000000000000000000000000000000
00000000000000000000000000000000
00000000000000000000000000000000
00000000000000000000000000000000
00000000000000000000000000000000
00000000000000000000000000000000
00000000000000000000000000000000
00000000000000000000000000000000
00000000000000000000000000000000
00000000000000000000000000000000
00000000000000000000000000000000
30000000000000000000000000000200
00000000000000000000000000000000
00000000000000000000000000000000
00000000000000000000000000000000
00000000000000000005000000000000
99999999999999999999999999999999
11111111111111111111111111111111