                                
                                
                                
          #####                 
          #   #                 
          #$ $#                 
        ###   ##                
        #   $  #                
      ### # ## #   ######       
      #   #$##$#####  ..#       
      # $           @ ..#       
      ##### ### # ##  ..#       
          #     #########       
          #######               
                                
                                
                                
                                